CODIGO->BLOQUE CODIGO'
CODIGO'->BLOQUE CODIGO'|ε
BLOQUE->ACCION BLOQUE'
BLOQUE'->salto ACCION BLOQUE'|ε
ANIDADO->ACCION salto ANIDADO'
ANIDADO'->ACCION salto ANIDADO'|ε
ACCION->CONDICIONAL|INSTRUCCION|COMENTARIO
CONDICIONAL->si ESPACIO CONDICION ESPACIO entonces salto ANIDADO SINO finsi
SINO->sino salto ANIDADO|ε
CONDICION->COMPARACION CONDICION'
CONDICION'->&& COMPARACION CONDICION'|or COMPARACION CONDICION'|ε
COMPARACION->BOOL COMPARACION'
COMPARACION'->== BOOL COMPARACION'|< BOOL COMPARACION'|> BOOL COMPARACION'|ε
BOOL->identificador|! identificador|CONSTANTE
COMENTARIO-># INSTRUCCION
INSTRUCCION->DECLARACION|ASIGNACION|LLAMADA
LLAMADA->FUNCION ESPACIO PARAMETROS
PARAMETROS->VALOR PARAMETROS'
PARAMETROS'->ESPACIO VALOR PARAMETROS'|ε
VALOR->identificador|CONSTANTE
FUNCION->obtener|publicar|cambiar|borrar
DECLARACION->variable ESPACIO identificador ASIGN
ASIGN->ESPACIO = ESPACIO EXP|ε
ASIGNACION->identificador ESPACIO = ESPACIO EXP
EXP->TERM EXP'
EXP'->+ ESPACIO TERM EXP'|- ESPACIO TERM EXP'|ε
TERM->FACTOR TERM'
TERM'->* FACTOR TERM'|/ FACTOR TERM'|ε
FACTOR->identificador|CONSTANTE|( EXP )
ESPACIO->space ESPACIO'
ESPACIO'->space ESPACIO'|ε
CONSTANTE->constante|' CADENA '
CADENA->∈Σ-' CADENA'
CADENA'->∈Σ-' CADENA'|ε